x	x	x	x	x	x	x	x	x	x	x	x
x	-	-	-	-	-	-	-	-	-	-	x
x	-	-	-	-	-	-	-	-	-	-	x
x	-	-	h	-	t	-	-	O	-	-	x
x	-	-	-	-	-	-	-	-	-	-	x
x	-	-	-	-	-	-	-	O	-	-	x
x	-	-	-	-	-	-	-	-	-	-	x
x	-	-	-	-	-	-	-	-	-	-	x
x	-	-	O	-	-	-	-	-	-	-	x
x	-	-	-	-	-	-	-	-	-	-	x
x	-	-	-	-	-	-	-	-	-	-	x
x	x	x	x	x	x	x	x	x	x	x	x