x	x	x	x	x	x	x	x	x	x	x	x	x	x	x
x	-	-	-	-	-	-	-	-	-	-	O	-	-	x
x	-	-	O	-	X	-	-	-	-	-	-	-	-	x
x	-	-	-	-	-	-	-	-	-	-	-	-	-	x
x	-	-	-	-	-	-	-	-	-	X	-	-	-	x
x	-	-	-	-	X	-	-	-	-	-	-	-	-	x
x	-	-	-	-	-	-	-	-	-	-	O	-	-	x
x	-	-	-	-	-	-	-	-	-	-	-	-	-	x
x	-	-	-	O	-	-	-	-	-	-	-	-	-	x
x	-	-	-	-	-	-	-	-	-	-	-	-	-	x
x	-	-	-	-	-	-	-	-	-	-	-	-	-	x
x	-	O	-	-	-	-	-	X	-	-	-	-	-	x
x	-	-	-	-	-	-	-	-	-	-	-	-	-	x
x	x	x	x	x	x	x	x	x	x	x	x	x	x	x