x	x	x	x	x	x	x	x	x	x	x	x	x	x
x	o	-	-	-	-	-	-	-	-	-	-	o	x
x	-	x	x	x	-	x	x	x	x	x	x	x	x
x	-	o	-	-	-	x	-	-	-	-	x	x	x
x	x	x	x	x	-	x	-	x	x	o	x	x	x
x	-	-	-	-	-	-	-	-	-	-	-	o	x
x	o	x	-	x	-	x	x	x	x	-	-	-	x
x	-	o	-	x	-	-	-	-	x	x	x	x	x
x	x	x	x	x	-	-	-	-	x	x	x	x	x
x	x	x	x	x	x	x	x	x	x	x	x	x	x